Wheel Wells  -  Morning Light
 Ellie Goulding  -  High For This (The Weeknd Cover)
Flying Lotus  -  Camel (Nosaj Thing Remix)
Rebeka  -  Stars (Mirror People Club Mix)
Grand Am  -  Power of Love
Radiohead  -  Lotus Flower (Jacques Greene Remix) 
Ray Charles  -  What I'd Say (Bobby C Sound TV Remix)
Bernhoft  -  Shout (C2C Remix)
Miami Horror  -  Moon Theory (Punks Jump Up Remix)
Sufjan Stevens  -  Futile Devices (Shigeto Remix)
Project 46  -  Atarax (Original Mix)
Zoo Brazil  -  There Is Hope (feat. Rasmus Kellerman)
Peggy Lee  -  Why Don't You Do Right (Jtuk86 Remix)
Ta-ku  -  Higher (Flume Remix)
Disclosure  -  Tenderly (Kidnap Kid Remix)
Strip Steve  -  Astral Projection (feat. Puro Instinct) (KiNK Instrumental)
Maker  -  Missing (Cave Painting Remix)
Little Majorette  -  Never Be The Same
Kris Menace vs Empire Of The Sun  -  Walking On A Dream Efeel (Leksy Mashup)
Florence and the Machine  -  Dog Days Are Over (Steve Pitron and Max Sanna Remix)
Onra  -  V.B.B. (feat. Jay Kin & Amalia)
TOKiMONSTA  -  Darkest (feat. Gavin Turek)
Jessie Ware  -  110%
Grimes  -  Vanessa (Gabriel Batz Remix)
Gorillaz  -  Doncamatic (Harry Love Remix)
GRiZ  -  You Got To Change
James Vincent McMorrow  -  Higher Love (Steve Winwood Cover)
DJ Shadow  -  Scale It Back (feat. Little Dragon)
Roisin Murphy  -  Demon Lover (feat. Wiley) (Audio Monsters Remix)
Oliver Koletzki  -  Hypnotized (feat. Fran)
Metric  -  Artificial Nocturne (Love Thy Brother Remix)
Delilah  -  Inside My Love (RedLight Remix)
Freddie Joachim  -  Keep Lovin' (feat. Carlitta Durand)
Parov Stelar  -  Distance (feat. Lylith)
Hudson Mohawke  -  OOOPS!!!
Alpine  -  Icypoles (Star Slinger Dreamix)
Electric Wire Hustle  -  Perception
Flying Lotus  -  Stunts (Mr. Oizo Cover)
