Cold Fingers  -  Spoons
Petit Biscuit  -  Sleepless
XXYYXX  -  Unknown (feat. Vanessa Elisha)
Kirk Spencer  -  Human (Crvvcks Remix)
Art Alfie  -  Easy to Love!
Pin Tweaks  -  Girl On The Wire
Turan  -  Departed
Gold Panda  -  Clarke's Dream
Dewy Sinatra  -  Questions
Kindness  -  World Restart (feat. Kelela & Ade)
Mikromusic  -  Takiego ChÅ‚opaka (Venter Remix)
Imagined Herbal Flows  -  Floating
Dead Horse Beats & Thomas White  -  Love Somebody
GingerAle  -  Night Is Yours (feat. Karren)
Teenage Mutants & Purple Disco Machine  -  The Path
Danny Darko  -  Butterfly (Like A) (feat. Jova Radevska) (Max Liese Remix)
LoftyLows  -  Home 
Autumn In June  -  Weeks
Cyril Hahn  -  Open (feat. Ryan Ashley)
Chrome Sparks  -  Losing U
Clem Beat'z  -  Aerial Distraction (feat. Robagain & Fred SaÃ¯ SaÃ¯)
Indian Summer  -  Shiner (feat. Ginger And The Ghost)
S (Jenn Ghetto)  -  Vampires (Swim Good Remix)
Kailo  -  Need Ya (feat. Aela Kae)
#XI  -  Broken Bones (feat. Sundays) (Love Inc. Cover)
Once A Tree  -  Tell Her (Petit Biscuit Remix)
Libano  -  Fernanda Peralta
Veyns  -  Submarine
Xavier Rudd  -  Follow The Sun (Time Square Western Disco Radio Edit) 
The Fugees  -  Rumble In The Jungle (Beshken Remix)
Transport Band  -  A MoÅ¼e By
Raury & Vancouver Sleep Clinic  -  Superfly
Monsoonsiren  -  Paper Tiger
Laura Welsh x Ang Low  -  Lifeline
Louis Mattrs  -  Oops x Wus Good
Tyde  -  Close
Feki  -  Nothing Lasts Forever
Bob Marley  -  Jammin (Kungs Remix)
Tricky  -  Sun Down (feat. Tirzah)
BUNT  -  Journey (feat. Emma Carn)
