TNGHT (Hudson Mohawke x Lunice)  -  Bugg'n
Essay & CoMa  -  Deceptive
Digitalism  -  Zdarlight (Realboy Remix)
Lana Del Rey  -  Summertime Sadness (Marcapasos Remix)
Toro Y Moi  -  New Beat (Party Girl Remix)
Disclosure  -  Control (feat. Ria Ritchie)
Bakermat  -  Black Cat John Brown (Original Mix)
Kanye West  -  All Of The Lights (Pretty Lights Remix)
Love Echo  -  Lovecats (The Cure Cover)
Youth Group  -  Forever Young (Alphaville Cover)
Chris Isaak  -  Wicked Game (Adriatique & Thyladomid Edit)
XXXY  -  I Know This Can't Be Love
Beni  -  Someone Just Like You (feat. Mattie Safer)
Jesse Futerman  -  What Have I Got? (feat. DJ Alibi)
Bona Fat  -  Nebulous
AMTRAC  -  Feel Good
Savant  -  Good Times (feat. Prince)
DRT  -  Rising Sun (The Boogaloo Crew Remix)
Flying Lotus  -  Auntie's Lock/Infinitum (feat. Laura Darlington)
Jack Steadman  -  Tsim Sha Tsui
Lykke Li  -  Silver Springs (Fleetwood Mac Cover)
Rioux  -  Nothing Comes From Nothing
SBTRKT  -  Gloss
De La Soul  -  All Good (feat. Chaka Khan) (Breakbeat Junkie Remix)
Mister Lies  -  False Astronomy
Miike Snow  -  The Wave (Flight Facilities Mix)
Holly Miranda  -  Slow Burn Treason (Jamie XX Remix)
King Charles  -  The Brightest Lights (feat. Mumford & Sons)
Left Boy  -  Healthy Ego
Titch  -  The Indigenous
The Jackson 5  -  I Want You Back (RogerSeventyTwo Remix)
Dems  -  Down On You (Hannes Fischer Remix)
Bon Iver  -  Perth (The Polish Ambassador Remix)
Telepopmusik  -  Smile (Natural High Remix)
The Real Tuesday Weld  -  Brazil
