Icebird  -  Charmed Life (Stereocool Tonite Remix) 
Oxford  -  Flashlight
Elite Gymnastics  -  Here In Heaven 2
Ludovico Einaudi  -  Divenire (Carsten Nicolai Remix)
Unknown Mortal Orchestra  -  Ffunny Ffrends
The Gaslamp Killer  -  Zalim
Princeton  -  Grand Rapids (RAC Remix)
Boogie Belgique  -  Donâ€™t Mean A Thing
XXYYXX  -  Alexis
DJ Falcon  -  Honeymoon (Louis La Roche Modernized Edit)
Hot Chip  -  Flutes (Cryptonites Edit)
Caribou  -  Sun (Hannes Fischer 2012 Edit)
M.I.A.  -  Bad Girls (Surkin Remix)
Volta Bureau  -  Hope 
Reflekt  -  Need To Feel Loved (Adam K & Soha Remix)
Of Monsters and Men  -  Little Talks (Bombay Bicycle Club Remix)
Mother Mother  -  Letâ€™s Fall In Love
Mika  -  Make You Happy (Cherokee Remix)
Anna Lunoe  -  Real Talk (feat. Touch Sensitive)
The Botaniks  -  Fond of Jane (feat. Bernhoft) (A Great Paulukka Remix)
Enya  -  Orinoco Flow (PrototypeRaptor's Sailing Away Bootleg Remix)
Everything Everything  -  MY KZ, UR BF (Grum Remix)
Gotye  -  Somebody That I Used To Know (feat. Kimbra) (Bastian Van Shield Remix)
Jamie Woon  -  Shoulda (Samy Chelly Remix)
Beat Connection  -  Lotus Blossom
Craig Martinson  -  You Are In Color
Public Enemy  -  Harder Than You Think (Featurecast Remix)
Finnebassen  -  It's Gonna Take A Long Time (Silly Pilly Edit) 
Kodiak Fur  -  Hi Luv
Ariel Pink's Haunted Graffiti  -  Only In My Dreams
Bon Iver  -  Hinnom, TX (Slow Magic Remix)
Disco Ruido!  -  Mrs. Love
Capital Cities  -  Nothing Compares 2 U (Sinead O'Connor Cover)
