Rebeka  -  Nothing To Give (feat. Mirror People)
Cyril Hahn  -  Perfect Form (feat. Shy Girls)
Feist  -  Don't Give Up (feat. Timber Timbre) (Peter Gabriel Cover)
Petite Douceur  -  Paris (Extended Love Club Remix)
Der Wanderer  -  Hold On
This Will Destroy You  -  Freedom Blade
William De Vaughn  -  Be Thankful For What You Got (FKJ Remix)
Everything Everything  -  Final Form (Cropper Remix)
Young Wolf Hatchlings  -  We Like To Party
High Highs  -  A Real Hero (College feat. Electric Youth Cover)
Nujabes  -  Feather (Instrumental)
Woman's Hour  -  Darkest Place (Oceaan Remix)
Woman's Hour  -  To The End (REID Remix)
Realboy  -  The Ritz
Disclosure  -  F For You (Onra Remix)
The Aston Shuffle  -  Comfortable (feat. Will Heard) (L D R U Remix)
Maribou State  -  Truths (feat. Jimi Nxir)
Rhye  -  The Fall (BRONX Night Dub)
Jamiroquai  -  Space Cowboy (Neptune Safari Remix)
Androma  -  Dyami
Billy  -  Mieta
David Bowie  -  Love Is Lost (James Murphy Remix)
Nighty Max  -  Tree House
The Geek & VRV  -  It's Because
BANKS  -  Change (The Chainsmokers Hot & Steamy Edit)
Josef Salvat  -  Hustler (Cri$p x Manja Remix)
Furns  -  Haunt Me
Star Slinger  -  Free
Arlissa  -  You're Not Alone (ATB Cover)
Henry Green  -  Electric Feel (Kygo Remix) (MGMT Cover)
London Grammar  -  If You Wait (Budo Remix)
Sufjan Stevens  -  Sister Winter (Broke For Free Remix)
Jakwob  -  Fade (feat. Maiday)
Drake  -  Too Much (Jessie Andrews & Jason Burns Remix)
New Theory  -  Beasts & Beauties
Birdy  -  Words As Weapons (Nico Pusch Bootleg Remix)
Nicolas Jaar  -  And I Say (Xinobi Edit)
Cherokee  -  Don't Matter (feat. Darianna Everett)
Ase & David Marston  -  Just A Little Lovin'
Viadrina  -  Jeannie
Flecs  -  Portmanteau
