Paul Simon  -  You Can Call Me Al (Flight Facilities Edit)
Kirk Spencer  -  In Treatment (feat. Louis Scott) 
The Flower Drums  -  Rain Drips On
Daft Punk  -  Random Access Memories (Vanderway Edit)
Snakehips  -  Days With U (Le Nonsense Remix)
Daughter  -  Run (LCAW Remix)
Mos Def  -  Umi Says (FaltyDL Edit)
Breakbot  -  Peanuts
Phoenix  -  Lisztomania (Vanilla Bootleg Remix)
George Maple  -  Fixed 
KarlK  -  Swan Dive
Geordie Little  -  Steel Strings (Kyson Rework)
 Czeslaw Niemen  -  Dziwny Jest Ten Swiat (Voskovy Remix)
Modjo  -  Lady (Kaytranada Remix)
Alex Clare  -  Too Close (Nico Pusch Remix)
Caribou  -  Lalibela (Thology Remix)
Gigamesh  -  When You're Dancing (RAC Mix)
Gabrielle Aplin  -  Home (umami & Alle Farben Edit)
Rhye  -  Open (Bondax Remix)
Darius & Crayon  -  Alicia
Johnny Nash  -  I Can See Clearly Now (Fennec & Wolf Edit)
The Notorious B.I.G. vs Jamiroquai  -  Notorious Insanity (Flight Facilities Mashup)
Art Of Shades  -  All Away (feat. Soukaina)
The Supermen Lovers  -  Starlight (Luca Agnelli Sax Mix)
Monitor 66  -  Follow You
SALM  -  Architecture (Piano Cover)
GodWolf  -  Another Me
FDVM  -  Shake'em Dance
Gigamesh  -  Don't Stop (feat. Jana Nyberg)
TWOS  -  Beautiful (She)
Royal Cheese  -  Red Chick
Kubix  -  Don't Worry I'm Okay (feat. Alicrity)
The Mast  -  UpUpUp (feat. Pandora Marie)
Shoot The Ghost  -  So Cold
Agnes Obel  -  Riverside (Lulu Rouge Remix)
Aloe Blacc  -  I Need A Dollar (Tensnake Remix)
Sandro Golia  -  Fet Chaker
Jurassic 5  -  Thin Line (feat. Nelly Furtado) (Blue Version Edit)
Breakbot  -  Easy Fraction (Yaaman Remix)
Neptune Safari  -  Adeline Is In A Water Drop
Laura Mvula  -  She (Eagles For Hands Remix)
Serge Gainsbourg & Brigitte Bardot  -  Bonnie & Clyde (KPTN Remix)
Chloe Martini  -  Now You Know (feat. Anna Paul)
Kirtur  -  Stay
Lianne La Havas  -  Elusive (fLako Remix)
Mr. Little Jeans  -  Oh Sailor (feat. The Silverlake Conservatory Of Music Youth Chorale)
Passenger  -  Feather On The Clyde (Stefan Biniak Private Edit)
Snakehips  -  On & On (feat. George Maple)
Tribes  -  Dancehall
Beverlay  -  Typically Her (Kaytranada Remix)
Uppermost  -  Shine
Nico  -  These Days (Plunk.Ton Remix)
Vollenbak  -  Flying Emery
Brodka  -  Granda (Dynamid Disco Bootleg Remix)
