EsbE  -  Ambient
Apollo Brown  -  Warm Rain
The Black Keys  -  I Got Mine (Tobacco Remix)
Chris Baio  -  The Silent
The Photographic  -  Secure (AMTRAC Remix)
Black Atlass  -  Castles
Nadine Carina  -  Storm/Calm (feat. Gated)
Max Liese  -  In The Clouds
Fallulah  -  I Lay My Head (Shook Remix) 
Breakbot vs Chromeo  -  Baby Be Night (Ugly Kids Mashup)
David Byrne & St. Vincent  -  Who
Jonas Rathsman  -  Tobago (TTT Remix)
The Kooks  -  Runaway (Lonsdale Boys Club Remix)
Destiny's Child  -  Say My Name (Cyril Hahn Remix)
King Krule  -  Rock Bottom
Gramatik vs The Beatles  -  Don't Let Me Down
Chilly Gonzales  -  You Can Dance (Gemini Club Remix)
Saturday, Monday  -  Headshake (feat. Julia Spada) 
Madeon  -  Minimix (Annie Mac Radio 1)
Breakbot  -  Iron Zombie (Neus Remix)
Flying Emerald  -  Moonflowers
Star Slinger  -  Take This Up
Lisa Mitchell  -  Neopolitan Dreams (Nilow Remix)
Metronomy  -  Loving Arms (Soul Clap's Shake A Leg Mix)
PNAU  -  Unite Us (Kris Menace Remix)
Holly Drummond  -  Out Of My Mind (Cross Them Out Remix)
Grimes  -  Oblivion (Baardsen Remix)
Miike Snow  -  Remedy (feat. Crookers) (Magik Johnson Vocal Remix)
Tours  -  Grand Lux
Swerve  -  Yesterday's Gone (feat. Co$$) (DJ Mentos Instrumental)
Santigold  -  Disparate Youth (The 2 Bears Remix)
Nathan Fake  -  The Sky Was Pink (Paul Kalkbrenner Remix)
Kate Bush  -  Running Up That Hill (Louis La Roche Remix)
The xx  -  Crystalised (Joris Delacroix Remix)
Cherokee & Kartell  -  Atwater
The Death Set  -  Yo David Chase! You P.O.V. Shot Me In The Head (feat. Diplo) (Cassettes Won't Listen Remix)
Opptimo  -  Locate
Diplo  -  About That Life (feat. Jahan Lennon)
This Is The Arrival  -  Wish We Were Lovers
CocoRosie  -  Werewolf (Noisy Remix)
P4NTHR  -  Night Drive
Jessie Ware  -  Valentine (feat. Sampha)
Phoenix vs. Kavinsky  -  Night Mania (Carlos Serrano Mix)
Myk.  -  For The People
Jerome LOL  -  Dusk
Youngblood Hawke  -  We Come Running (MyKill and Party Ben Remix)
Mumford & Sons  -  Little Lion Man (Hot Young Girls Make Lovestep Remix)
Tennis  -  Guiding Light (Television Cover)
