Kavinsky  -  Odd Look (feat. The Weekend) 
Phoenix  -  Trying To Be Cool (Grum Remix)
Washed Out  -  Donâ€™t Give Up
Joe Goddard  -  Step Together (feat. Boris Dlugosch)
Parov Stelar  -  Keep On Dancing (feat. Marvin Gaye)
Rod Stewart  -  Da Ya Think I'm Sexy (Zimmer Rework)
Rebeka  -  Melancholia (Kamp! Remix)
Claire  -  Games (Talul Remix)
The Howling  -  Shortline (Frank Wiedemann Remix)
Matt Nathanson  -  Love Comes Tumbling Down (De Hofnar Bootleg)
Isaac Delusion  -  Early Morning
Flume  -  Left Alone (feat. Chet Faker) (Ta-ku Remix)
Lykke Li  -  I Follow Rivers (Redsparrow Remix)
Lexer  -  Lights (Oliver Schories Remix)
BT  -  Dynamic Symmetry
Otonomi  -  Goodnight
Insightful  -  Question All Things
Bastille  -  No Angles (TLC vs The XX) (feat. Ella)
Poolside  -  Harvest Moon (Neil Young Cover)
Younker  -  Victoria
J.J. Cale  -  After Midnight (The Tailors Remix)
Mons Montis  -  Swept
Cold Fingers  -  Honeybee
LUUUL  -  The Morning After (feat. Anna Paul)
Tiger Tsunami  -  Antarctica
The Rolling Stones  -  Miss You (Glenn Dale Rework)
Clare Maguire  -  Paper Thin
The Polyphonic Spree  -  Popular By Design
Laura Veirs  -  July Flame (Gamper & Dadoni Remix)
Fisz & Emade  -  Dziecko We Mgle (Remix)
Voyager  -  The Last Question (Voyager Remix)
Lana Del Rey  -  Young & Beautiful (Marcus Schossow Summer Remix)
Foals  -  My Number (Parachute Youth Remix)
Empire Of The Sun  -  Alive (Gold Fields Remix)
Moby  -  One Of These Mornings (Haugli's Mix)
Ducktails  -  Killin' The Vibe (Eby Le Beatz Remix)
Bee Gees  -  Tragedy (Forever Kid Remix)
Walt Ribeiro  -  Harder, Better, Faster, Stronger (Daft Punk Cover)
Cee-Roo  -  John Lennon
Alt-J  -  Breezeblocks (Nightkraft Remix)
Zero 7  -  On My Own (feat. Danny Pratt)
some minor noise  -  Coffers
LBCK  -  I Don't Need Nobody
