Flight Facilities  -  Foreign Language (feat. Jess) (Beni Remix)
Bibio  -  The Ephemeral Bluebell (Cocolino Edit 2011)
Dave Brubeck  -  Unsquare Dance (Chris Holford Remix)
Adam Yauch off Beastie Boys dead at 47 (Beastie Boys  -  Body Movin')
Yppah  -  Film Burn (feat. Anomie Belle)
Gnarls Barkley  -  Reckoner (Radiohead Cover)
Gary Jules  -  Mad World (Paul Kalkbrenner Remix)
Michael Jackson  -  Don't Stop 'Til You Get Enough (Gigamesh Remix)
Dillon  -  Thirtheen Thirtyfive (Sheila Hill Bootleg)
Lykke Li  -  Until We Bleed (NiconÃ© Remix)
Grouplove  -  Tongue Tied (Gigamesh Remix)
Bobby Womack  -  California Dreaming (The Mamas & The Papas Cover)
Mighty Mike  -  Beggin' For Glory (Portishead vs Madcon Mashup)
June  -  Rocket Boy (feat. Marcelina)
Sunday Girl  -  Where Is My Mind (The Pixies cover)
VinRoc  -  BeWithMe
Cee-Lo  -  No One's Gonna Love You (Paul Epworth Mix) (Band Of Horses Cover)
The XX  -  You Got The Love (Florence and the Machine Cover)
Goldfish  -  Hold Tight (Anotsu Remix)
Eliza Doolittle  -  Money Box (Jamie XX Remix)
Nneka  -  Shining Star (Joe Goddard Remix)
Mr. Little Jeans  -  The Suburbs (Arcade Fire Cover)
Kid Cudi  -  Pursuit of Happiness (feat. MGMT & Ratatat) (Steve Aoki Remix)
Teepee  -  Time Meant Nothing
RAC  -  Hollywood (feat. Penguin Prison)
Deluxe  -  Superman (feat. Taiwan MC)
Neneh Cherry + The Thing  -  Dream Baby Dream (Four Tet Remix)
Loyal Divide  -  Vision Vision (R/D Remix)
SALM  -  Schubert A La Mode (The Sexinvaders Edit)
Giselle Rosselli  -  Silk
Theophilus London  -  Wine And Chocolate (Andhim Edit)
Filip Filipi  -  Filip's Revolutionary Etude In D Minor (produced by Jonathan Lee)
Bombay Bicycle Club  -  Shuffle (Leo Zero Remix)
Burial + Four Tet  -  Nova
Bobby Womack  -  Dayglo Reflection (feat. Lana Del Rey)
Kill Paris  -  Shades of Funk
Handbook  -  Marilyn Monroe
Coldplay vs Buena Vista Social Club  -  Clocks (Rhythms del Mundo)
Caribou  -  Kaili (Analphabeth Remix)
