Saint Saviour  -  I Call This Home (Kissy Sellout's Vinyl Fryah Remix)
Bat For Lashes  -  Laura (Alfonso Muchacho Remix)
New Theory  -  Ines (Part II)
Plaid Dragon  -  Dog Physics
Voyageur  -  No Hibernation
Jose Gonzalez  -  Heartbeats (Chris Hanke & Heimlich Knuller Edit)
MHYH  -  Heartache (Kosski Remix)
Julia Stone  -  This Love (Egokind Edit)
Gui Boratto  -  No Turning Back (Original Mix)
Message To Bears  -  Mountains (FlicFlac Edit)
I, Aeronaut  -  Everything
Handbook  -  Sunrising
Real Cosby  -  Heart Felt Good 
Bakermat  -  Leven
Beat Culture  -  Useless
Felicity Groom  -  Trophy Talk (Diger Rokwell Remix)
AlunaGeorge  -  Thinking Bout You (Frank Ocean Cover)
Black Sabbath  -  Planet Caravan (Poolside Rework)
Dillon  -  Hey Beau (Makit Edit)
Clayton X  -  Ya Ready (Radio Edit)
Andras Fox  -  I'm In Love
Bonobo  -  Silver (Krizz Luco Edit)
Daughter  -  Youth (Alle Farben Remix)
We Are Augustines  -  Chapel Song
Aleah  -  Water and Wine (Stefan Biniak Private Edit)
Bit Funk  -  The Long Road Ahead
Unknown Mortal Orchestra  -  Swim and Sleep (Like A Shark) (Little Dragon Remix)
Marius Drescher  -  Between Love and Hate
Jamie Berry  -  Delight (feat. Octavia Rose)
Grimes  -  Skin (Four Tet Remix)
Lykke Li  -  Dance Dance Dance (Artenvielfalt Edit)
Four Tet  -  Untitled (off 0181 LP)
Spleen United  -  My Love (Justin Timberlake Cover)
ViLLAGE  -  Lane Wolf
C2C  -  Happy (feat. D. Martin)
Paul Schulleri & Eiblonski  -  Tusnelda (Worakls Remix)
Little Dragon  -  Twice (Blendthon Bootleg)
Cour Vette  -  Cafe Disco
 Bacalao & Sonne  -  Undress Your Mind
Jamie Berry  -  Delight (Max Liese Remix)
MS MR  -  Dark Doo Wop (Chet Faker Remix)
The Tumbled Sea  -  Untitled For Piano
Tracy Chapman  -  Give Me One Reason (The Tailors Remix)
Bonga  -  Mona Ki Ngi Xica (Synapson Remix)
Bondax  -  Gold (Snakehips Remix)
The Box Tops  -  The Letter (Bakermat Remix)
Jose Gonzalez  -  Crosses (Moritz Guhling's Beschutzer Remix)
Civil Twilight  -  Letters Form The Sky (Elephantitan Remix)
Jamie xx  -  Far Nearer (T.H.I.E.F.S Remix)
Maroon 5  -  One More Night (Com Truise Remix)
Gold Panda  -  Parents (The Voyager Remix)
Freddie Mercury  -  Living On My Own (The Egg Remix)
David Bowie  -  Golden Years (Tim Fuchs Edit)
Digitalism  -  Pogo (VanGuard Remix)
MMOTHS  -  All These Things (feat. Holly Miranda)
Ben Howard  -  Depth Over Distance (Esteble Remix)
