Alina Baraz & Galimatias  -  Pretty Thoughts
Trickski  -  Good Time To Pray (feat. Ernesto)
Bastian's Happy Flight  -  Come For The Early (Stay For The Late) (Sweater Beats Remix)
Akshin Alizadeh  -  Down The Street
Zigitros  -  Witch Hunt (Mannequine Remix)
Tears & Marble  -  What Is Love (Haddaway Cover)
Soosh  -  Always (SHIGETO's What We've Been Thru Redux)
Question  -  Osanha
Mansionair  -  Hold Me Down (feat. Revier)
Weirddough  -  High Tide
Scoffers  -  Words
Scheinizzl  -  Searching
Fever Kids  -  Holding Grass
Charlotte OC  -  Colour My Heart (MOWE Bootleg)
Mereki  -  Blue Lake (WMNSTUDIES Remix)
Sampha  -  Too Much (Loston Remix)
Digitalism  -  Fahrenheit 32
DJ Koze  -  Nices WoÌˆlkchen (feat. Apparat)
DJ Clock & Beatenberg  -  Pluto (Remember You)
MVSCLES  -  Sweet N Sour
Duck Sauce  -  Mondo
Fryars  -  Cool Like Me (Mike Skinner Remix)
Dalo  -  Motion (feat. Cammie Robinson) (Agnostica Remix)
Romo  -  Her Smile
Cee-Roo  -  Give It Up (feat. James Brown)
Cillie Barnes  -  Veranda (RAC Remix)
Pat Lok  -  Same Hearts (feat. Bear Mountain)
Daktyl  -  Do Without
Radiohead  -  Thinking About You (Flint Remix)
The Irrepressibles  -  In This Shirt (RÃ¶yksopp Remix)
Fiction  -  The Apple (For Alan Turing)
Flying Lotus  -  Wake Me
Chmara Winter  -  Tucy Chacy (feat. KARI)
Beyonce  -  Grown Woman (Monsieur Adi Remix)
Goldn Retriever  -  I Feel Great Now
Tensnake  -  Love Sublime (feat. Niles Rodgers & Fiora) (Duke Dumont Remix)
