Bonobo  -  First Fires (feat. Grey Reverend)
Venice Beach  -  Oh Oh Disco
Phil Collins  -  Another Day In Paradise (Lucas Turschmann Remix)
Everything But The Girl  -  Driving (Pete Oak Remake)
Ailo  -  Cialo
London Grammar  -  Wasting My Young Years (NDMA Remix)
Flight Facilities  -  I Didnâ€™t Believe (feat. Elizabeth Rose)
Sivu  -  Better Man Than He (Eagles For Hands Remix)
Audible Mainframe  -  Nobody's Nomad (feat. Toussaint)
Phoenix  -  Trying To Be Cool (RAC Mix)
The Who  -  Baba O'Riely (SebastiAn Remix)
The Victoria's  -  Concorde (Funk LeBlanc Remix)
Jeremih  -  Fuck You All The Time (Shlohmo Remix)
Motion of Hips  -  Politic (Louie Louie Remix)
Passion Pit  -  Carried Away (The Golden Pony Remix)
MAUSI  -  Losing You/Say My Name (Solange & Destiny's Child Cover)
Neil Young  -  Heart Of Gold (Florian Paetzold Edit)
Wild Belle  -  It's Too Late (Employee Of The Year Remix)
C-ro & Liza Flume  -  What We Called Love
Banks  -  Warm Water (feat. Totally Enormous Extinct Dinosaurs)
Scheinizzl  -  One More (Salzach Version)
Dave Owen  -  Deep Breathin'
Magical Mistakes  -  It's Cold And Beautiful
The Doors  -  Peace Frog (The Captain Remix)
Midimum  -  Junk Beach (Last Minute Version)
Herve  -  Feelin' Good
Le Quack  -  St. Lucia
Akeda  -  Meanings
Riva Starr  -  Kill Me (feat. Rssll)
Jacques Greene  -  On Your Side (feat. How To Dress Well)
Modeselektor  -  Shipwreck (feat. Thom Yorke)
Whilk And Misky  -  Wing Clipper
Wafia  -  Alice (Japanese Wallpaper Remix)
Catz 'n Dogz  -  Good Love (feat. KiNK)
Sono  -  Keep Control (H.O.S.H. Remix)
Kosski  -  Prune
Bipolar Sunshine  -  Rivers
Super Magic Hats  -  Wind (Japanese Wallpaper Rework)
Klang Kind  -  Bring Hope
Chic  -  I Want Your Love (Le Nonsense Re-Vision)
Flight Facilities  -  I Didn't Believe (feat. Elizabeth Rose) (Lou Teti Remix)
Keith Kenniff  -  Ten Thousand Places
Ed Drewett  -  Good Morning (Monsieur Adi Remix)
Cassius vs. Outkast  -  Feeling For Rosa (1999) (Flight Facilities Mashup)
Lowing  -  I Will Wait For You (Everybody Wants To Be A Cowboy)
OMN  -  Betwixt
Madonna  -  Get Together (Aviddiva Remix)
