Breakbot  -  Another Dawn (feat. Irfane)
SBTRKT  -  Hold On (Sisi Bakbak Remix)
TOKiMONSTA  -  Cupidity
deadmau5  -  Codex (Radiohead Cover)
Lana Del Rey  -  Ride (Active Child Remix)
Evil Needle  -  Falling Leaves
Compuphonic  -  Sunset (feat. Marques Toliver)
Tempogeist  -  Romeo (Monitor 66 Remix)
Chromeo  -  Bonafied Lovin (RAC Remix)
Aeroplane  -  We Canâ€™t Fly (Oliver Remix)
Notorious B.I.G. vs. Washed Out  -  Hypnotize Portlandia (Chi Duly Edit)
SebastiAn  -  Love In Motion (feat. Mayer Hawthorne)
Flight Facilities  -  Clair De Lune (feat. Christine Hoberg)
Cassius  -  The Sound Of Violence (Aeroplane Remix)
Dragonette  -  Easy (Fabian Remix)
Flight Facilities  -  Foreign Language (feat. Jess) (Will Saul & Tam  Cooper Remix)
Youth Lagoon  -  Daydream (Noah Hyde Remix)
MADE IN HEIGHTS  -  All The Places
Coeur De Pirate  -  Wicked Games (The Weeknd Cover)
Tina Turner  -  Whats Love Got To Do (Zimmer Rework)
Florian Bery  -  Eden (Get Down)
Jeff & Jessey  -  Looking For The Sun (Silver Disco Remix)
Jonas Mantey  -  Wie Alles Begann
BenZel & Jessie Ware  -  If You Love Me
Kilo Kish  -  Creep Wave
Cosmic Kids  -  Never Going Back Again (Fleetwood Mac Cover)
The Drums  -  Days (Trentemoller Remix)
Joey Chicago  -  Jane (2011 Rework)
Russian Red  -  Cigarettes (Bastian Le Bel Edit)
Paul McCartney vs. Louis La Roche  -  Forthlin Road (Live Version)
Young Wolf Hatchlings & Thomas D'Arcy  -  You Lovely You
C2C  -  Mack the Knife (Tribute to Louis Armstrong)
The Mowgli's  -  San Francisco (Little Daylight Remix)
Dillon  -  Thirteen Thirtyfive (Jonas Woehl Edit)
Aeroplane  -  In Her Eyes (feat. Jamie Principle)
Imogen Heap  -  Hide and Seek (She Said Disco Remix)
Bombay Bicycle Club  -  How Can You Swallow So Much Sleep (Sam Lewis Bootleg Remix)
Blue Satellite  -  Jet Lag
The Other Tribe  -  Don't Need No Melody (Kidnap Kid Remix)
