Amerie  -  One Thing (Polkadot Remix)
Kosski  -  Nina
MihayLove  -  Love You Tool (feat. Veela) (Snow Forts Nightmare Remix)
Cold Fingers  -  Know
Coleman Hawkins  -  On The Bean (Bakermat Remix)
Clubfeet  -  Latch (Disclosure Cover) 
Mr. Troy  -  The Dream
PNAU  -  Baby (Breakbot Remix)
Daft Punk  -  No End (We Plants Are Happy Plants Remix)
The xx  -  Finally (Kings of Tomorrow Cover)
Shadows On Stars  -  Little Bit (Lykke Li Cover)
Boris Dlugosch  -  Look Around You (feat. Roisin Murphy)
Rihanna  -  Stay (Marius Horsturz Edit)
Kirk Spencer  -  Kukcu (feat. Safia May)
Frank Wiedemann  -  Howling (feat. Ry)
Handbook  -  Tumble
Tree.  -  Sacred Elements (feat. Finn Rivera)
Poolside  -  Slow Down (Pixelated Remix)
Classified  -  Inner Ninja (City Lies Remix)
Teenage Mutants & Andre Crom  -  Hanging On
Teen Daze  -  Light & Love
AlunaGeorge  -  I Wanna Be Like You (Jungle Book Cover)
The Hood Internet  -  Suit And Commercial (Justin Timberlake vs Daft Punk)
James Blake  -  Digital Lion (feat. Brian Eno)
Miami Horror  -  I Look To You (Tim Fuchs Remix)
Yuksek  -  Extraball (feat. Amanda Blank) (Breakbot Remix)
Mario Basanov and Vidis  -  I'II Be Gone (feat. Jazzu) (Cocolino Edit)
Sza  -  Ice.Moon
Bon Iver  -  Blood Bank (FlicFlac Edit)
T. Rex  -  Get It On (Virgin Magnetic Material Remix)
Bon Iver  -  Flume (Kulkid Remix)
Emma Louise  -  Jungle (Kanzler & Wischnewski Edit)
The xx  -  Reconsider (Jamie xx Remix)
Archive  -  Day That You Go (Rampue Remix)
Joe Goddard  -  Gabriel (feat. Valentina)
Maison Francaise  -  1975
M83  -  Outro (Markus Toepfer Edit)
Wall  -  Left To Wonder
Fitz & The Tantrums  -  Money Grabber (Party Supplies Remix)
Cosmo Sheldrake  -  Rich (feat. Anna Roo)
James Blake  -  Limit To Your Love (Bodega Remix)
Edward Newgate  -  Sunny Days (feat. The Tallest Man On Earth)
Patrick Ebert & Stefan Biniak  -  Natural Born Jane
Daughter  -  Perth/Ready For The Floor (Bon Iver vs Hot Chip Mashup)
Handbook  -  Spirits
Hiatus  -  We Can Be Ghosts Now (feat. Shura)
RAC  -  Lovefool (feat. Liz Anjos) (The Cardigans Cover)
Mind Not The Timid  -  Flood
Seven  -  Look Behind Your Futur
Susanne Vega  -  Tom's Diner (Rampue Remix)
Keith Kenniff  -  For Hollie
kubek  -  Last Year
Jake Bugg  -  Someone Told Me (Peer Kusiv Remix)
Lana Del Rey  -  Burning Desire (Alkalino Remix)
Le Main  -  Kobenhavn
Vulfpeck  -  Adrienne & Adrianne (Happen to Bossa Nova)
EveryBoard Festival 2013  -  See you there!
Cass.  -  Tuulipuu Janka (feat. Anna Marjamaki)
Parra For Cuva  -  Lines (feat. Anna Naklab)
