Andras Fox  -  Your Life
Cocolino  -  Platonic Love
Jamie Berry  -  Dirty Stop Out
Kav Verhouzer & Straight From The Fridge  -  Soepel
Agnes Obel  -  Fuel To Fire (Xinobi Rework)
Flume  -  Insane (feat. Moon Holiday) (L D R U Remix)
 Laura Mvula  -  Sing To The Moon (Klangkarussell Remix)
NVOY  -  Is It Good
The Pharcyde  -  Runnin' (Bit Funk Remix)
Ages  -  Fog (Nosaj Thing Cover)
Kloter  -  Recovery
Jamie Berry  -  Super Mario Bros (Electro Swing Remix)
Emil HeroÌ  -  Love (feat. Hedvig)
Brolin  -  Portland (Machweo Remix)
Kyson  -  Ocean Tides (thvn Remix)
Sixth Avenue Express  -  Deeper Love
Jim James  -  Know Til Now (Pixelated Remix)
Dillon Francis  -  Without You (feat. Totally Enormous Extinct Dinosaurs)
Sam Smith x Nile Rodgers x Disclosure x Jimmy Napes  -  Together
Jerome LOL  -  Always (feat. Sara Z)
Jamie xx  -  Untitled (Unreleased)
Milou  -  High For You
TCTS  -  These Heights (feat. Shivum Sharma)
Kinder Raum  -  La Pluie Triste (Ferdinand Remix)
Waze & Odyssey  -  Love That (Burns Hot Enough)
Tinashe  -  Vulnerable (feat. Travi$ Scott)
Grizzly Bear  -  Will Calls (Diplo Remix)
Sivu  -  I Hold (feat. Marika Hackman)
Cheap N' Chill  -  Get Together
Mighty Mouse  -  Stuck
Bonobo  -  First Fires (feat. Grey Reverend) (Maya Jane Coles Remix)
Chris Malinchak  -  Call My Name
YellowStraps & Moodprint  -  Landscapes
Shy Girls  -  Second Heartbeat (The Kite String Tangle Remix)
Stay Positive  -  Blood Brother (TACHES Remix)
X Priest X  -  Dark Sun
TEEMID & Joie Tan  -  Crazy (Gnarls Barkley Cover)
James Blake  -  I Never Learnt To Share (Golden Vessel Edit)
