Michael Jackson  -  Off The Wall (GMGN Remix)
Gossip  -  Perfect World (AIO Le Disco Remix)
RJD2  -  The Good Life (feat. Blueprint)
Lancelot  -  We Can Dance (Goldroom Remix)
Moritz Guhling  -  Luftabom 
Lifelike & Popular Computer  -  Getting High (Pyramid Remix)
Cee-Roo  -  Jackson 5
Dreampeter  -  Guesswork
Postiljonen  -  How Will I Know / All That We Had Is Lost (Whitney Houston Cover)
Marvin Gaye  -  Sunny (.OZ Remix)
Mutemath  -  In No Time (Pierce Fulton Remix)
Wolf Rider  -   For You (Jeremy Word Remix)
WhoMadeWho  -  Never Had The Time (Dominic Gertz Remix)
Cold Fingers  -  Demon
Star Slinger  -  Mornin' (Edit 2012)
Tesla Boy  -  Fantasy (feat. Dasha Malygina)
Bondax  -  Just Smile For Me (feat. Bobbie Gordon)
Lisa Alma  -  Outbalance (Schaarup Remix)
Trentemoller  -  Miss You (Nils Hoffmann Edit)
The Smiths  -  This Charming Man (Luis Leon Bootleg)
Doctor Dru  -  The Voice of Dru
Meskie Granie  -  Ognia! (Cocolino & Motojo Remix)
Royksopp  -  Running To The Sea (feat. Susanne Sundfor)
Passenger  -  Let Her Go (Peer Kusiv Edit)
We Fell To Earth  -  The Double
Red Mystery  -  Jetlands (Ron Flatter & Nick D-Lite Edit)
The National  -  Runaway (David Keller Remix)
LCD Soundsystem  -  Your Love Away From Me (Dave Wrangler Re-edit)
Beat Connection  -  Think/Feel (Saint Etienne Remix)
Main Automation  -  Have You Ever (feat. Steelwood)
Cold Fingers  -  Carving Lovers
Angus Stone  -  Wooden Chair (Main Automation Edit)
Bon Iver  -  Towers (Stop The Car Remix)
Thomas Scholz  -  I Do What I Can (Patty Kay's Honeymoon Remix)
Cub Scouts  -  Evie
Saint Saviour  -  Midnight City (M83 Cover)
Compuphonic  -  Artifice
 James Vincent McMorrow  -  Down The Burning Ropes (Patrick Schulze Rework)
Kat Vinter  -  Stoneheart
Maribou State  -  Scarlett Groove (feat. Saint Saviour)
