GroupLove  -  Colours (Xaphoon Jones Remix)
Caribou  -  Sea Rea
Gil Scott-Heron & Jamie XX  -  I'll Take Care Of U
Ourvais  -  Some Funk
Nighty Max  -  Iglou
Ellie Goulding  -  Your Song (Blackmill Dubstep Remix)
Marvin Gaye  -  Got To Give It Up (Kill Them With Colour Remix)
Two Door Cinema Club  -  Something Good Can Work (RAC Mix) 
Ratatat  -  Drugs (Nguzunguzu Remix)
Onra  -  Mechanical
Eskmo vs Bjork  -  Rhythm Joga
Nathan Fake  -  The Sky Was Pink (IKKI Remix)
Klaxons  -  Golden Skans (Sebastian Remix)
Mark Foster  -  Warrior (feat. A-Trak & Kimbra)
Parachutes  -  Paper Birds
Nujabes  -  Luv (Sic) Part 3 (Instrumental)
Infinite Potentials  -  Lovesng
Bonobo & Speech Debelle  -  Sun Will Rise 
I Blame Coco  -  Quicker (Shook Remix)
Javelin  -  Tryouts
Halina Larsson  -  Fires And French Horns (Alf Tumble Remix)
Volta Bureau  -  Alley Cat
Niki and the Dove  -  Mother Protect (Goldroom Remix)
Kanye West vs The xx  -  Touch The Sky (Carlos Serrano Mix)
Radiohead  -  Everything In Its Right Place (Remix Gigamesh)
Friendly Fires  -  Skeleton Boy (GRUM Remix)
Asa & With Joyful Lips  -  FranÃ§oise
Phoenix  -  1901 (D.L.I.D Remix)
League  -  Golden Maps
Capsule  -  Feelin' Alright (Golden Guitar Remix)
Freestylers feat. Belle Humble  -  Cracks (Losers Remix)
Kid Cudi  -  Falling Star (R3K Remix)
Major Lazer  -  Get Free (feat. Amber of Dirty Projectors)
The Knocks  -  Midnight City (feat. Mandy Lee) (M83 Cover)
 The Roots  -  Dear God 2.0 (feat. Monsters of Folk) (Zeds Dead Remix)
Gorillaz  -  Crystalised (The xx Cover)
The Chemical Brothers  -  Asleep From Day (Brummer Remix)
Xaphoon Jones  -  Jackson Pit (Passion Pit vs. Jackson 5)
Florence and The Machine  -  Addicted To Love (Robert Palmer Cover)
Left Boy  -  Video Games (feat. Mirakle)
Dakent  -  Banger (Voodoo Bear Remix)
Metric  -  Twilight Galaxy (Gladkill Remix)
Marina & The Diamonds  -  Obsessions (Monsieur Adi Remix)
Calvin Harris  -  I'm Not Alone (Deadmau5 Remix)
Jack 5's  -  Dancing Machine (Kreap's Vintage Redux)
Radiohead vs Dave Brubeck  -  Five Step (Mashup by Overdub)
Falcons  -  Must Be Luv
Lykke Li  -  Velvet (The Big Pink Cover)
