Fisz Emade Tworzywo  -  Åšlady (feat. Justyna ÅšwiÄ™s)
Fauve  -  Bermudes (Astre Vision)
HuggerMugger  -  Anywhere But Here
Moods  -  Kinetics
Alp / Alp  -  With You (feat. Beg)
Southes.  -  Filling Your Cup
Nick Klein  -  Paralyzed
Only Girl  -  Feel It (JMâˆ†C Remix)
Liu Bei  -  Fields (feat. Rachel Goswell) (Slowdive)
Sailor & I  -  Turn Around (Ã‚me Remix)
Mozambo & Basic Tape  -  Bright Side (feat. Julia Church)
Jimmy Napes  -  Give It Up
Harrison & Seamus Hamilton  -  Mugen
Belwoorf  -  Church Point
Raury  -  Fly (feat. Malik Shakur)
TCTS  -  Coupe De Ville (feat. Aniff Akinola)
Local Natives  -  Ceilings (Bahari Remix)
dOP  -  You (Ohmer Remix)
RÃ¶yksopp  -  Sordid Affair (WatermÃ¤t Remix)
Lana Del Rey  -  Brooklyn Baby (Yuksek Remix)
Inca  -  Wake Me Up
HAWK  -  Clock Hands
NeavÃª  -  Audrey
AKIINE  -  Frid (Niva Remix)
Flight Facilities  -  Heart Attack (feat. Owl Eyes) (Female Remix)
RYSY  -  Ego (feat. Justyna ÅšwiÄ™s)
Lisa Alma  -  Man
RITUAL  -  Middle Of The Bed (Lucy Rose Cover)
Macajey  -  Out For A Run (feat. Ashley Macachor)
MMOTHS  -  Yago
Pat Lok  -  All In My Head (feat. DesireÌe Dawson)
Alice Boman  -  Red Eyes (The War On Drugs Cover)
