Paul Simon  -  Diamonds On The Soles Of Her Shoes (Ame Private Remix)
Feist  -  Caught A Long Wind (Lexer's Little Bird Remake)
Sam Smith  -  Lay Me Down (Saux Remix)
Digitalism  -  Circles (Eric Prydz Remix)
Charli XCX  -  You (Ha Ha Ha) (Burns Violet Cloud Remix)
Bondax  -  Gold (Star Slinger Refix)
Washed Out  -  The Sound of Creation
Johnossi  -  Man Must Dance (Crussen Edit)
The Whitest Boy Alive  -  1517 (TTT Remix)
Christian Loffler  -  Eleven (feat. Mohna)
Andrew Bird  -  Three White Horses (Bastian Le Bel Edit)
Fabu  -  Going Through
Dido  -  No Freedom (J. Viewz Remix)
LUUUL  -  Night Love (feat. Loumar)
5 Reasons  -  Nightdrive in Moscow
Phonothek  -  Bilderbuch
Candi Staton  -  Young Hearts Run Free (Mirko & Meex Re-Touch)
Death From Above 1979  -  You're A Woman I'm A Machine (Christian AIDS Remix)
Two Door Cinema Club  -  Next Year (Shields Remix)
Rodriguez  -  Hate Street Dialogue (Round Table Knights Searching For Sugar Man Edit)
Estelle  -  American Boy (feat. Kanye West) (Moustache Machine Remix)
FernWeh  -  Tonladen
Saux  -  Hoagy
FKJ  -  So Much To Me
Barbara Keith  -  All Along The Watchtower (Rayko Edit)
rampue  -  Love You
Electric Guest  -  Awake (Dennis Rivera Remix)
SunKids  -  Rise Up (feat. Chance) (Mercury Edit)
Four Tet & RocketNumberNine  -  Roseland
Midi MatildaÂ  - Â Day Dreams (MyKill Remix)
Clarian & Guy Gerber  -  Claire
Compuphonic  -  Sunset (feat. Marques Toliver) (Aeroplane Remix)
Disclosure  -  White Noise (feat. AlunaGeorge) (Hudson Mohawke Remix)
Gem Club  -  Twins (Rauschfaktor M Edit)
Rae Morris  -  From Above
Claptone  -  Wrong
CarnivalsÂ  - Â Swallow The Sky
Marijn van der Meer  -  Where The Heart Is (Phonothek Edit)
Imagine Dragons  -  Radioactive (Labetzki Remix)
Bonobo  -  Heaven For The Sinner (feat. Erykah Badu)
Finkk  -  Hoffnung
Martin Kay  -  Undone
Roku  -  Not Enough Seoul (Intro)
