East End Villains  -  They Don't Deceive Me
Andres  -  New For U
Daft Punk  -  Something About Us (Cherokee Remix)
audioCrunch  -  Roll With Me
Cherokee  -  Do It Again
The Cinematic Orchestra  -  To Build A Home (Rauschfaktor M Edit)
Lemonade  -  Softkiss (Pional Remix)
Larse  -  Tonite (Original Mix)
The XX  -  Fiction (Synapson Remix)
Young Benjamins  -  Bones
The Middle East  -  Blood (Kill Them With Colour Remix)
Different Sleep  -  Turbulence
Cosmic Kids  -  Freight To My Soul
Kopecky Family Band  -  Heartbeat
Mayer Hawthorne  -  No Strings (RAC Remix)
Lest Diet  -  Laked Nadies
Hussle Club  -  IHHEFWIWTBBITMIDSTSBAM (Bird Peterson Remix)
Fleetwood Mac  -  Dreams (Gigamesh Edit)
Ben Howard  -  The Fear (Moonlight Matters Rework)
Foster The People  -  Don't Stop (TheFatRat Remix)
Hidden Orchestra  -  The Burning Circle
Calvin Harris  -  Sweet Nothing (feat. Florence Welch) (Burns Remix)
Foals  -  Miami (Tim Fuchs feat. Flight Facilities Remix)
Massive Attack & Warpaint & Mark Lanegan  -  Crystalised (The xx Cover)
Kids Of 88  -  Tucan (feat. Alisa Xayalith)
The Refresher  -  Together In Heaven
Lykke Li  -  Silent My Song (Ricow Kalio Remix)
Two Door Cinema Club  -  Sun (Gigamesh Remix)
Janet Jackson  -  If (Kaytranada Remix)
Mark Ronson  -  A La Modeliste (feat. Erykah Badu, Trombone Shorty, Mos Def, Zigaboo Mo)
Theme Park  -  Jamaica (Becoming Real Remix)
Jonsi  -  Tornado (B-Mania Remix)
Bon Iver  -  Minnesota, WI (Lovely Remix)
Luca C & Brigante  -  Lucio (Nicolas Jaar & Dave Harrington Live Edit) 
Nelly Furtado  -  Parking Lot (Melee Remix)
Lykke Li  -  Dance Dance Dance (Buraka Som Sistema Remix)
Erykah Badu  -  Love Of My Life (Kaytranda Remix)
The xx  -  Chained (Panic City Remix)
Zee Avi  -  Concrete Wall (Pumpkin Remix)
Kosski  -  Future (feat. Loumar)
Destiny's Child  -  Cater 2 U (Carling Ruse vs. Ruddyp Remix)
Rebeka  -  Roksana (B Szczesny Remix)
Stardust vs. Anthony Atcherley  -  Music Sounds Better In Paris (Anthony Atcherley Bootleg) 
Bonobo  -  Wonder When (feat. Andreya Triana)
Real Cosby  -  Boof
