Souls Of Mischief  -  93 'Til Infinity (Spornberger Bootleg)
Phoria  -  Once Again (Layzie Edit)
Portugal. The Man  -  Endangered Song
Youth Lagoon  -  Cannons (EBY Remix)
Max Liese & Alex Brandt  -  Soleado
Dads  -  Return To (feat. Tom Snowdon)
Ghostpoet  -  Meltdown (Tomasz Pieklo Remix)
ColeCo  -  Disco Babe
SBTRKT  -  Temporary View (feat. Sampha)
T V A  -  Sensual (Faking It)
Matt Corby  -  What The Devil Has Made
Oliver Koletzki  -  After All (feat. NoÌˆrd) (Claptone Remix)
TEV  -  Acid Love (feat. Steven Sober)
Flamingo  -  Heart, My (Riffie Remix)
Luna Aura  -  Radio
Esta  -  Dancing In Punta Fuego
Sebastian Carter  -  Stranger Sights (feat. Henry Green)
Felix Jaehn  -  Shine (feat. Freddy Verano & Linying)
LUKA  -  LOWDOWN
Fabich & Ferdinand Weber  -  Joy
MFSB & The Salsoul Orchestra  -  Love Is The Message (Danny Krivit Edit)
Freeform Five  -  Leviathan (feat. Roisin Murphy) (Compuphonic Remix)
Toro Y Moi  -  Still Sound (Vindata Remix)
Snakehips  -  Days With You (feat. Sinead Harnett)
Yumi Zouma  -  Riquelme (EssaÌy Remix)
Embody  -  Make A Stand (feat. Barnaby)
Midland  -  Before We Leave
Lusine  -  Two Dots (Chad Valley's Turks & Caicos Edit)
LUUUL  -  Summer Lights
Les Loups  -  Colourblind (feat. Cybil)
Au Revoir Simone  -  Fade Into You (feat. Nikolai Fraiture) (Mazzy Star Cover)
The Hellen Hollins Singers  -  Consolation (Nicolas Jaar Edit)
FKA twigs  -  Ultraviolet (Insightful Fondle)
