Memoryhouse  -  Old Haunts (LTR Remix)
Foo Fighters  -  Everlong (Louis La Roche Rework)
Charles Murdoch  -  Dekire (feat. Oscar Key Sung) (Bodhi Remix)
RAC  -  Let Go (feat. Kele & MNDR)
Norma Jean Martine  -  Mexico
Milky Chance  -  Fairytale (Florian Paetzold Bootleg)
Chloe Howl  -  How Proud
Yes It's Ananias  -  United States Of America (CRISTALLIN Remix)
Flex Cop  -  This Is Not Meth
Sir Own  -  Hooked (Kon's Nite Time Remix)
Burn Selector Festival  -  Warsaw 2013
Jon Hopkins  -  Breathe This Air (feat. Purity Ring)
Sir Sly  -  Gold (Gold Fields Remix)
Napoleon  -  Foolish Pride
Awon & Phoniks  -  Escaping Youth
Jade  -  Every Day Of The Week (Stwo Edition)
Teedra Moses  -  Be Your Girl (Kaytranada Remix)
Jaymes Young  -  What Is Love (Haddaway Cover)
AMTRAC  -  How Can She
Two Door Cinema Club  -  Sun (RICD Remix)
Monkeybrain  -  Sonnenschein
Mads Bjorn  -  White Trees
Uppermost  -  Saving The World
Honey Bones  -  Brevity
Retrograde  -  Going Up
Disclosure  -  Help Me Lose My Mind (feat. London Grammar) (Paul Woolford Remix)
Kimbra  -  Cameo Lover (Shook Remix)
Say Lou Lou  -  Feels Like We Only Go Backwards (Tame Impala Cover)
The Very First Teenager  -  Bluedark
Lupe Fiasco  -  Daydreamin' (feat. Jill Scott) (Jerry Folk Remix)
Cat Power  -  Satisfaction (Trashyouth Remix)
Jagwar Ma  -  Come Save Me (Flight Facilities Graceland Remix)
SvanSikh  -  I Wanna Be Your Lover
Saux  -  Only For Today (feat. Joya Mooi)
Flamingosis  -  Extra Lovely
Massive Attack  -  Teardrop (Theatre Of Delays Remix)
Barny Carter  -  Bouquet
Chvrches  -  The Mother We Share (Moon Boots Remix)
